PFCL=POUSSINS F ARC CLASSIQUE
PHCL=POUSSINS H ARC CLASSIQUE
BFCL=BENJAMINES F ARC CLASSIQUE
BHCL=BENJAMINS H ARC CLASSIQUE
MFCL=MINIMES F ARC CLASSIQUE
MHCL=MINIMES H ARC CLASSIQUE
CFBB=JEUNES F ARC NU
CFCL=CADETTES F ARC CLASSIQUE
CFCO=CADETTES F ARC A POULIES
CHBB=JEUNES H ARC NU
CHCL=CADETS H ARC CLASSIQUE
CHCO=CADETS H ARC A POULIES
JFCL=JUNIORS F ARC CLASSIQUE
JFCO=JUNIORS F ARC A POULIES
JHCL=JUNIORS H ARC CLASSIQUE
JHCO=JUNIORS H ARC A POULIES
SFBB=SCRATCH F ARC NU
SFCL=SENIORS F ARC CLASSIQUE
SFCO=SENIORS F ARC A POULIES
SHBB=SCRATCH H ARC NU
SHCL=SENIORS H ARC CLASSIQUE
SHCO=SENIORS H ARC A POULIES
VFCL=VETERANS F ARC CLASSIQUE
VFCO=VETERANS F ARC A POULIES
VHCL=VETERANS H ARC CLASSIQUE
VHCO=VETERANS H ARC A POULIES
SVFCL=SUPER VETERANS F ARC CLASSIQUE
SVFCO=SUPER VETERANS F ARC A POULIES
SVHCL=SUPER VETERANS H ARC CLASSIQUE
SVHCO=SUPER VETERANS H ARC A POULIES
FEDERAL-PFCL=FEDERAL POUSSINS F ARC CLASSIQUE
FEDERAL-PHCL=FEDERAL POUSSINS H ARC CLASSIQUE
FEDERAL-BFCL=FEDERAL BENJAMINES F ARC CLASSIQUE
FEDERAL-BHCL=FEDERAL BENJAMINS H ARC CLASSIQUE
FEDERAL-MFCL=FEDERAL MINIMES F ARC CLASSIQUE
FEDERAL-MHCL=FEDERAL MINIMES H ARC CLASSIQUE
FEDERAL-CFBB=FEDERAL JEUNES F ARC NU
FEDERAL-CFCL=FEDERAL CADETTES F ARC CLASSIQUE
FEDERAL-CFCO=FEDERAL CADETTES F ARC A POULIES
FEDERAL-CHBB=FEDERAL JEUNES H ARC NU
FEDERAL-CHCL=FEDERAL CADETS H ARC CLASSIQUE
FEDERAL-CHCO=FEDERAL CADETS H ARC A POULIES
FEDERAL-JFCL=FEDERAL JUNIORS F ARC CLASSIQUE
FEDERAL-JFCO=FEDERAL JUNIORS F ARC A POULIES
FEDERAL-JHCL=FEDERAL JUNIORS H ARC CLASSIQUE
FEDERAL-JHCO=FEDERAL JUNIORS H ARC A POULIES
FEDERAL-SFBB=FEDERAL SCRATCH F ARC NU
FEDERAL-SFCL=FEDERAL SENIORS F ARC CLASSIQUE
FEDERAL-SFCO=FEDERAL SENIORS F ARC A POULIES
FEDERAL-SHBB=FEDERAL SCRATCH H ARC NU
FEDERAL-SHCL=FEDERAL SENIORS H ARC CLASSIQUE
FEDERAL-SHCO=FEDERAL SENIORS H ARC A POULIES
FEDERAL-VFCL=FEDERAL VETERANS F ARC CLASSIQUE
FEDERAL-VFCO=FEDERAL VETERANS F ARC A POULIES
FEDERAL-VHCL=FEDERAL VETERANS H ARC CLASSIQUE
FEDERAL-VHCO=FEDERAL VETERANS H ARC A POULIES
FEDERAL-SVFCL=FEDERAL SUPER VETERANS F ARC CLASSIQUE
FEDERAL-SVFCO=FEDERAL SUPER VETERANS F ARC A POULIES
FEDERAL-SVHCL=FEDERAL SUPER VETERANS H ARC CLASSIQUE
FEDERAL-SVHCO=FEDERAL SUPER VETERANS H ARC A POULIES
FITA-PFCL=FITA POUSSINS F ARC CLASSIQUE
FITA-PHCL=FITA POUSSINS H ARC CLASSIQUE
FITA-BFCL=FITA BENJAMINES F ARC CLASSIQUE
FITA-BHCL=FITA BENJAMINS H ARC CLASSIQUE
FITA-MFCL=FITA MINIMES F ARC CLASSIQUE
FITA-MHCL=FITA MINIMES H ARC CLASSIQUE
FITA-CFBB=FITA JEUNES F ARC NU
FITA-CFCL=FITA CADETTES F ARC CLASSIQUE
FITA-CFCO=FITA CADETTES F ARC A POULIES
FITA-CHBB=FITA JEUNES H ARC NU
FITA-CHCL=FITA CADETS H ARC CLASSIQUE
FITA-CHCO=FITA CADETS H ARC A POULIES
FITA-JFCL=FITA JUNIORS F ARC CLASSIQUE
FITA-JFCO=FITA JUNIORS F ARC A POULIES
FITA-JHCL=FITA JUNIORS H ARC CLASSIQUE
FITA-JHCO=FITA JUNIORS H ARC A POULIES
FITA-SFBB=FITA SCRATCH F ARC NU
FITA-SFCL=FITA SENIORS F ARC CLASSIQUE
FITA-SFCO=FITA SENIORS F ARC A POULIES
FITA-SHBB=FITA SCRATCH H ARC NU
FITA-SHCL=FITA SENIORS H ARC CLASSIQUE
FITA-SHCO=FITA SENIORS H ARC A POULIES
FITA-VFCL=FITA VETERANS F ARC CLASSIQUE
FITA-VFCO=FITA VETERANS F ARC A POULIES
FITA-VHCL=FITA VETERANS H ARC CLASSIQUE
FITA-VHCO=FITA VETERANS H ARC A POULIES
FITA-SVFCL=FITA SUPER VETERANS F ARC CLASSIQUE
FITA-SVFCO=FITA SUPER VETERANS F ARC A POULIES
FITA-SVHCL=FITA SUPER VETERANS H ARC CLASSIQUE
FITA-SVHCO=FITA SUPER VETERANS H ARC A POULIES
